01 01 01 01 01 01 01 01 01 01 01 01 01 01 01
01 01 01 01 01 01 01 02 02 01 01 01 01 01 01
01 01 02 02 01 01 01 02 02 01 01 01 01 01 01
01 01 02 02 01 04 06 06 06 06 06 06 06 06 06
01 01 01 01 01 05 06 05 05 05 05 05 05 05 05
01 01 03 01 05 05 09 05 05 05 05 05 05 05 05
01 01 03 01 05 08 08 08 05 05 01 01 01 01 01
01 01 02 02 01 149 149 149 01 01 01 01 01 01 01
01 01 02 02 01 149 149 149 01 01 01 01 01 01 01
01 01 03 03 01 149 149 149 01 01 01 01 01 01 01
